Note: Do not change the headings in this file, they are used to detect problems	
Status Bar Message	Tool Tip
F1 für Hilfe drücken	
Neue Karte erstellen	Neue Karte
Existierende Karte öffnen	Karte öffnen
Aktuelle Karte speichern	Karte speichern
Aktuelle Karte unter neuem Namen speichern	Karte speichern unter
Programminformationen, Versionsnummer und Copyright anzeigen	Info
Karten-Editor beenden	Ende
Hilfethemen anzeigen	Hilfethemen
Hilfe zu aktuellem Befehl anzeigen	Hilfe
Diese Karte öffnen	
Markiertes Objekt in die Zwischenablage kopieren	Kopieren
Markiertes Objekt ausschneiden und in die Zwischenablage kopieren	Ausschneiden
Einen bestimmten Objekttyp finden	
Inhalt der Zwischenablage einfügen	Einfügen
Letzte Aktion rückgängig machen	Rückgängig
Letzte rückgängig gemachte Aktion wiederholen	Wiederholen
Fenstergröße ändern	
Fensterposition verändern	
Fenster auf Symbolgröße minimieren	
Fenster auf Vollbild maximieren	
Fenster schließen	
Normale Fenstergröße wiederherstellen	
Untergrundkarte anzeigen	Untergrund
Passierbarkeit der Objekte auf der Karte anzeigen	Passierbarkeit
Terrain platzieren	Terrain-Tool
Flüsse platzieren	Fluss-Tool
Straßen platzieren	Straßen-Tool
Objekte löschen	Radiergummi
Erd-Objekte platzieren	Erd-Objekte
Sand-Objekte platzieren	Sand-Objekte
Gras-Objekte platzieren	Gras-Objekte
Schnee-Objekte platzieren	Schnee-Objekte
Sumpf-Objekte platzieren	Sumpf-Objekte
Ödland-Objekte platzieren	Ödland-Objekte
Unterirdische Objekte platzieren	Unterirdische Objekte
Lava-Objekte platzieren	Lava-Objekte
Wasser-Objekte platzieren	Wasser-Objekte
Städte platzieren	Städte
Monster platzieren	Monster
Helden platzieren	Helden
Artefakte platzieren	Artefakte
Schätze platzieren	Schätze
Objekte auf der Karte animieren	
Karten-Spezifikationen bearbeiten	
1x1 Terrain-Pinsel auswählen	1x1-Felder Pinsel
2x2 Terrain-Pinsel auswählen	2x2-Felder Pinsel
4x4 Terrain-Pinsel auswählen	4x4-Felder Pinsel
Terrain-Bereichspinsel auswählen	Bereichspinsel
Terraintyp Erde wählen	Erde
Terraintyp Sand wählen	Sand
Terraintyp Gras wählen	Gras
Terraintyp Schnee wählen	Schnee
Terraintyp Sumpf wählen	Sumpf
Terraintyp Ödland wählen	Ödland
Terraintyp Unterirdisch wählen	Unterirdisch
Terraintyp Lava wählen	Lava
Terraintyp Wasser wählen	Wasser
Klaren Flusstyp wählen	Klarer Fluss
Vereisten Flusstyp wählen	Vereister Fluss
Verschlammten Flusstyp wählen	Verschlammter Fluss
Flusstyp Lava wählen	Lava-Fluss
Schotterstraße wählen	Schotterstraße
Pflasterstraße wählen	Pflasterstraße
1x1 Terrain-Radierer auswählen	1x1-Felder Pinsel
2x2 Terrain-Radierer auswählen	2x2-Felder Pinsel
4x4 Terrain-Radierer auswählen	4x4-Felder Pinsel
Bereichs-Radierer auswählen	Bereichs-Radierer
Keinen Spieler auswählen	
Spieler %s auswählen	
Feldweg auswählen	Feldweg
Terraintyp Fels wählen	Fels
Ausgewähltes Objekt löschen	Löschen
Eigenschaften des ausgewählten Objektes anzeigen	Eigenschaften
Gitternetz anzeigen	Gitter
Allgemeine Objekte platzieren	Allgemeine Objekte
1x1-Felder Pinsel auswählen	1x1-Felder Pinsel
2x2-Felder Pinsel auswählen	2x2-Felder Pinsel
4x4-Felder Pinsel auswählen	4x4-Felder Pinsel
Bereichs-Pinsel auswählen	Bereichspinsel
Karte auf mögliche Probleme prüfen	Karte testen
Karten-Terrain animieren	
Anwendungsoptionen bearbeiten	
Text aus der aktuellen Karte in eine Textdatei exportieren	
Text aus einer Textdatei in die aktuelle Karte importieren	
Ausgewähltes Objekt beschreiben	
Suche nächstes Objekt der zuletzt angegebenen Art	
Suche voriges Objekt der zuletzt angegebenen Art	
Aus der Karte herauszoomen	Herauszoomen
In die Karte hereinzoomen	Hereinzoomen
Symbolleiste anzeigen oder verbergen	Symbolleiste
Statusleiste anzeigen oder verbergen	Statusleiste
Modusleiste anzeigen oder verbergen	Modusleiste
Hindernisse automatisch platzieren	Hindernis-Werkzeug
1x1 soliden Pinsel auswählen	1x1 solider Pinsel
2x2 soliden Pinsel auswählen	2x2 solider Pinsel
4x4 soliden Pinsel auswählen	4x4 solider Pinsel
Soliden Bereichspinsel auswählen	Solider Bereichs-Pinsel
1x1 ausgefransten Pinsel auswählen	1x1 ausgefranster Pinsel
2x2 ausgefransten Pinsel auswählen	2x2 ausgefranster Pinsel
4x4 ausgefransten Pinsel auswählen	4x4 ausgefranster Pinsel
Ausgefransten Bereichspinsel auswählen	Ausgefranster Bereichs-Pinsel
1x1 soliden Radierer auswählen	1x1 solider Radierer
2x2 soliden Radierer auswählen	2x2 solider Radierer
4x4 soliden Radierer auswählen	4x4 solider Radierer
Soliden Bereichs-Radierer auswählen	Solider Bereichs-Radierer
1x1 ausgefransten Radierer auswählen	1x1 ausgefranster Radierer
2x2 ausgefransten Radierer auswählen	2x2 ausgefranster Radierer
4x4 ausgefransten Radierer auswählen	4x4 ausgefranster Radierer
Ausgefransten Bereichs-Radierer auswählen	Ausgefranster Bereichs-Radierer
Hindernisse in markierten Bereichen platzieren	Hindernisse platzieren
Den Fluss-Radierer auswählen	Fluss-Radierer
Den Straßen-Radierer auswählen	Straßen-Radierer
